111111
1P0101
1000C1
1E0001
111111
