1111111111
100C000001
1000000P01
100E000001
1111111111
