111111
10C101
100E01
1P0001
111111
