111111
100101
110PC1
1E0001
111111
