11111111111111111111111111111111
10000000000000000000000000000001
10000000000000000000000000000001
10000000000000000000000000000001
10000000000000000000000000000001
10000000000000000000000000000001
10000000000000000000000000000001
10000000000000000000000000000001
1000000000000000000P000000000011
1000000000E000000000000000000001
10000000000000000000000000000001
10000000000000000000000000000001
10000000000000000000000000000001
1CCCCCCCCCCCCCCC0000000000000001
10000000000000000000000C00000001
10000000000000000000000000000001
11111111111111111111111111111111
