11111111111
1P100000101
1E0C0000011
11111111111
