11111111111
1P1000001C1
100000000C1
100C00E0001
11111111111
