11111111111
1P1000E0101
10E000000C1
11111111111
